NO ./textures/map2/no.xpm
SO ./textures/map2/so.xpm
WE ./textures/map2/we.xpm
EA ./textures/map2/ea.xpm


F 0,70,0
C 255,255,200


11111111111111111111111
10S10000100000000000001
10010111100101011111001
10010000000101000001001
10000100111111011111001
10010100000000000000001
10010100100000111111001
10011110100000100010001
10000000100000001000101
11111111111111111111111
