NO ./textures/map3/no.xpm
SO ./textures/map3/so.xpm
WE ./textures/map3/we.xpm
EA ./textures/map3/ea.xpm

C 200,200,200
F 30,130,30

111111111111111111111
101000001000000000001
101010101011111110001
100010100010000010001
121110101211101021101
100000101000101000001
101111101011101112111
101000001010100000101
101011111010112110101
101010001010100010101
101110101010101010101
100000101010001010001
112111101011211011101
100000101000100010001
101110101110101110111
101000100000100010101
101011211112111010101
100010000000000010001
102010111011121111101
1N1000001000000000001
111111111111111111111
